10
8
GXXX TRAN TRAN GXXX GXXX GXXX GXXX GXXX
TRAN TRAN TRAN TRAN TRAN TRAN TRAN TRAN
GXXX GXXX GXXX GXXX GXXX TRAN TRAN TRAN
TRAN TRAN TRAN TRAN TRAN TRAN TRAN TRAN
GXXX GXXX GXXX TRAN TRAN TRAN GXXX GXXX
GXXX GXXX GXXX TRAN TRAN GXXX GXXX GXXX
GXXX GXXX GXXX TRAN GXXX GXXX GXXX GXXX
GXXX GXXX TRAN TRAN TRAN GXXX GXXX GXXX
TRAN TRAN TRAN TRAN TRAN TRAN TRAN TRAN
GXXX GXXX GXXX GXXX GXXX GXXX GXXX GXXX
